-FRUITS:
APPLE → apple
ORANGE → orange
BANANA → banana
MANGO → mango
PEAR → pear
PLUM → plum
JACKFRUIT → jackfruit
COCONUT → coconut
WATERMELON → watermelon
MELON → melon
CANTALOUPE → cantaloupe
MANGOSTEEN → mangosteen
POMELO → pomelo
GRAPE → grape
PEACH → peach
STARFRUIT → starfruit
LEMON → lemon
PASSIONFRUIT → passionfruit
DURIAN → durian
LYCHEE → lychee
LONGAN → longan
STRAWBERRY → strawberry
BLUEBERRY → blueberry
KIWI → kiwi
DRAGONFRUIT → dragonfruit
FIG → fig
CACAO → cacao
AVOCADO → avocado
CHERRY → cherry
RASPBERRY → raspberry
GUAVA → guava
LIME → lime
APRICOT → apricot
PAPAYA → papaya
PINEAPPLE → pineapple

-OCCUPATIONS:
DOCTOR → doctor 
NURSE → nurse 
TEACHER → teacher 
STUDENT → student 
PUPIL → pupil 
ENGINEER → engineer 
PROGRAMMER → programmer 
REPORTER → reporter 
JOURNALIST → journalist 
ANNOUNCER → announcer 
ACTOR → actor 
DIRECTOR → director 
SINGER → singer 
MUSICIAN → musician 
ARTIST → artist 
ARCHITECT → architect 
PILOT → pilot 
ATTENDANT → attendant 
DRIVER → driver  
POLICE → police 
SOLDIER → soldier 
FIREFIGHTER → firefighter 
GUARD → guard 
LAWYER → lawyer 
ACCOUNTANT → accountant 
RECEPTIONIST → receptionist 
SECRETARY → secretary 
TAILOR → tailor 
ELECTRICIAN → electrician 
MECHANIC → mechanic 
BARBER → barber 
FARMER → farmer 
MINER → miner 
TECHNICIAN → technician 
ATHLETE → athlete 
COACH → coach 
GAMER → gamer 
STREAMER → streamer 
YOUTUBER → youtuber 
TIKTOKER → tiktoker 
CHEF → chef
JUDGE → judge
BAKER → baker
DENTIST → dentist
VET → vet
ACTRESS → actress
WAITER → waiter
SCIENTIST → scientist

-ANIMALS:
DOG → dog 
CAT → cat 
BIRD → bird 
CHICKEN → chicken 
DUCK → duck 
GOOSE → goose 
BUFFALO → buffalo 
COW → cow 
GOAT → goat 
SHEEP → sheep 
PIG → pig 
HORSE → horse 
TIGER → tiger 
LION → lion 
LEOPARD → leopard 
FOX → fox 
BEAR → bear 
PANDA → panda 
MONKEY → monkey 
ELEPHANT → elephant 
RHINO → rhino 
HIPPO → hippo 
GIRAFFE → giraffe 
DEER → deer 
WOLF → wolf 
SNAKE → snake 
COBRA → cobra 
SHARK → shark 
WHALE → whale 
DOLPHIN → dolphin 
SEAHORSE → seahorse 
CATFISH → catfish 
EEL → eel 
SALMON → salmon 
TUNA → tuna 
CROCODILE → crocodile 
SHRIMP → shrimp 
CRAB → crab 
SNAIL → snail 
CLAM → clam  
JELLYFISH → jellyfish 
OCTOPUS → octopus 
SQUID → squid 
BEE → bee 
BUTTERFLY → butterfly 
MOSQUITO → mosquito 
ANT → ant 
ROACH → roach  
SPIDER → spider 
BEETLE → beetle 
MANTIS → mantis 
FROG → frog 
TOAD → toad 
TURTLE → turtle 
OSTRICH → ostrich 
PEACOCK → peacock 
SPARROW → sparrow 
DOVE → dove 
PENGUIN → penguin 
FLAMINGO → flamingo 
FALCON → falcon 
SEAGULL → seagull 
EAGLE → eagle 
HAWK → hawk  
CRICKET → cricket 
FISH → fish
MOUSE → mouse
RAT → rat
BAT → bat
OWL → owl
SWAN → swan
WORM → worm
FLY → fly
ALLIGATOR → alligator
KANGAROO → kangaroo
ZEBRA → zebra
RABBIT → rabbit